22222222222
20322222222
22333332222
22222233312
22222222222