3333333333333333322233333
3333333333333333223333333
3333333333333332233333333
3333330333333333233333333
3333333333333333333333333
3333333333333332333333333
2222222233333332331333333
3333333222223332333333333
3333333333322322333333333
3333333222222223333333333
3333333233333223333333333
3333333233333323333333333
3333333233333322233333333
3333332233333333222333333