33333333333332333333
33333333333332233333
33333333333333233333
33333330333333233333
33333333333333233222
33333333333333232233
33333333333322332333
33333333333223322333
22333222322233323333
32333233333322223133
32233233333333333333
33223223333333333333
33322233333333333333
33333333333333333333
33333333333333333333