333333333333
333133333333
333131100333
332111130033
332113130033
333111330433
333311003443
333333333333
333333333333
333333333333
333333333333
333333333333